{
  "start":
  {
    "level":  [
                [266,  267,  267,  267,  267,  257,  267,  267,  267,  266],
                [267,  257,  257,  257,  257,  257,  257,  257,  257,  267],
                [267,  257,  257,  257,  257,  257,  257,  257,  257,  267],
                [267,  257,  257,  257,  257,  257,  257,  257,  257,  267],
                [267,  257,  257,  257,  257,  257,  257,  257,  257,  267],
                [267,  257,  257,  257,  257,  257,  257,  257,  257,  267],
                [267,  257,  257,  257,  257,  257,  257,  257,  257,  267],
                [267,  257,  257,  257,  257,  257,  257,  257,  257,  267],
                [267,  257,  257,  257,  257,  257,  257,  257,  257,  267],
                [266,  267,  267,  267,  267,  267,  267,  267,  267, 266]
              ],
              
    "up": "room1",
    "right": "none",
    "down": "none",
    "left": "none"
  },

  "room1":
  {
    "level":  [ 
                [266,  267,  267,  267,  267,  267,  267,  267,  267,  266],
                [267,  257,  257,  257,  257,  257,  257,  257,  257,  267],
                [267,  257,  257,  257,  257,  257,  257,  257,  257,  267],
                [267,  257,  257,  257,  257,  257,  257,  257,  257,  267],
                [257,  257,  257,  257,  257,  257,  257,  257,  257,  267],
                [267,  257,  257,  257,  257,  257,  257,  257,  257,  267],
                [267,  257,  257,  257,  257,  257,  257,  257,  257,  267],
                [267,  257,  257,  257,  257,  257,  257,  257,  257,  267],
                [267,  257,  257,  257,  257,  257,  257,  257,  257,  267],
                [266,  267,  267,  267,  267,  257,  267,  267,  267, 266]
      ],
              
    "up": "none",
    "right": "none",
    "down": "start",
    "left": "room2"
  },

  "room2":
  {
    "level":  [ 
                [266,  267,  267,  267,  267,  267,  267,  267,  267,  266],
                [267,  257,  257,  257,  257,  257,  257,  257,  257,  267],
                [267,  257,  257,  257,  257,  257,  257,  257,  257,  267],
                [267,  257,  257,  257,  257,  257,  257,  257,  257,  267],
                [267,  257,  257,  257,  257,  257,  257,  257,  257,  257],
                [267,  257,  257,  257,  257,  257,  257,  257,  257,  267],
                [267,  257,  257,  257,  257,  257,  257,  257,  257,  267],
                [267,  257,  257,  257,  257,  257,  257,  257,  257,  267],
                [267,  257,  257,  257,  257,  257,  257,  257,  257,  267],
                [266,  267,  267,  267,  267,  267,  267,  267,  267, 266]
      ],
              
    "up": "none",
    "right": "room1",
    "down": "none",
    "left": "none"
  }

  
  
}
